2,2,2,2,2,2,2,2
2,0,0,0,0,21,0,2
2,0,0,0,0,0,0,2
2,0,0,0,0,0,0,2
2,0,99,0,0,0,101,2
2,1,1,1,1,1,1,2